XXXXXXXXXXXXXXXXXXXX
X   XXXXXX     X XXX
X   XXXXXX  XX X XXX
XXX XXXXXX  XX X XXX
X X XX         X XXX
X X XX XXX  XX X XXX
X      XXX  XX X XXX
X   XXXXXX  XX X XXX
X        X   X   XXX
XXXXXXXXXXXXXXXXXXXX
